{
    "data": [
        "ffcd53",
        "f49ac1",
        "fe8430",
        "7bccc8",
        "7c56b8",
        "bbd647",
        "ffcd53",
        "c6aaf2",
        "ff8431",
        "f79779",
        "d5575e",
        "ffcd53",
        "7bccc8",
        "ff8431",
        "76bbf4",
        "bbd647",
        "e6b8e6",
        "ffcd53",
        "d5575e",
        "f79779",
        "ffcd53",
        "ff8431",
        "d5575e",
        "7c56b8",
        "5eb9bd",
        "ffcd53",
        "c6aaf2",
        "ff8431",
        "7bccc8",
        "bbd647",
        "f48334",
        "ffcd53",
        "a0354d",
        "5eb9bd",
        "7859a4",
        "f48334",
        "ffcc54",
        "c6aaf2",
        "bbd647",
        "f399c1",
        "73b0e0",
        "b54239",
        "f18c33",
        "225e87",
        "85b6e2",
        "85b6e2",
        "85b6e2",
        "667bab",
        "f16c7d",
        "3ba1c4",
        "cc486f",
        "e05f63",
        "a1ce56",
        "f6914f",
        "73b0e0",
        "667bab",
        "fbb153",
        "fbb74c",
        "f69069",
        "e79041",
        "225e87",
        "fe8181",
        "5ecae0",
        "364049",
        "fbaa27",
        "f47626",
        "fcb415",
        "2f6874",
        "a88fc3",
        "ae6a5b",
        "7089c5",
        "914b4b",
        "84b699",
        "bad647",
        "9f6f92",
        "d27c2d",
        "ea6866",
        "bcc1e2",
        "fecd56",
        "fecd56",
        "91b4a6",
        "f78235",
        "dc2635",
        "bbd642",
        "f48f8a",
        "98b1ed",
        "ec7b81",
        "60b6ba",
        "f78235",
        "bbd642",
        "5076b9",
        "f4821f",
        "dd5ba0",
        "a89e98",
        "51b6b9",
        "51b6b9",
        "51b6b9",
        "bad647",
        "7bccc8",
        "f16949",
        "f287ae",
        "e78746",
        "a91f23",
        "df9f27",
        "5f8d9e",
        "1d486d",
        "ea7f27",
        "7c1417",
        "bb74a3",
        "1881c4",
        "bad647",
        "f36f43",
        "006c86",
        "f68d1e",
        "53495e",
        "a05050",
        "226c9e",
        "c93a27",
        "6d5281",
        "a3cc40",
        "da623c",
        "c875b0",
        "7dab41",
        "c85a27",
        "739d40",
        "bbd642",
        "f0544a",
        "f9b099",
        "ff9a36",
        "9ad6d2",
        "fec326",
        "38b4e7",
        "ff8383",
        "eb524f",
        "a5cf8a",
        "3ba5ad",
        "E5725E",
        "A8DCE0",
        "FAAE58",
        "66ACDF",
        "50B748",
        "F4C1BE",
        "f79336",
        "783423",
        "b9393a",
        "d05e28",
        "89a63d",
        "108843",
        "349ea3",
        "bfad5d",
        "8b2642",
        "0d6665",
        "ec8d8c",
        "c73627",
        "aec746",
        "adce5b",
        "a35d53",
        "4c8a9d",
        "d95e2f",
        "0f8740",
        "863a96",
        "bad648",
        "93668e",
        "5058a7",
        "459bd5",
        "396430",
        "ad3024",
        "da5842",
        "8b2e77",
        "c0c547",
        "c26869",
        "9bd26b",
        "827fad",
        "835275",
        "3a3a4b",
        "4e5f97",
        "ba6a7b",
        "c7607f",
        "3f4e58",
        "d26c27",
        "0a8d00",
        "688210",
        "f59524",
        "8c424d",
        "ea8136",
        "608ab3",
        "b54239",
        "f4821f",
        "dd5ba0",
        "5076b9",
        "85b6e2",
        "ea8676",
        "73b0e0",
        "ce5077",
        "739f70",
        "F18E46",
        "f16949",
        "7bccc8",
        "f7a99c",
        "50b748",
        "faae58",
        "fbb74c",
        "fbb74c",
        "ec5573",
        "f69069",
        "cf3934",
        "3ba5ad",
        "FAAE58",
        "66ACDF",
        "50B748",
        "A8DCE0",
        "F4C1BE",
        "E5725E",
        "872d23",
        "ff905f",
        "487805",
        "d64537",
        "2e8a7b",
        "243e4c",
        "008b81",
        "645a95",
        "db8375",
        "ffcd53",
        "8a4532",
        "d3240e",
        "82392f",
        "ab3b2c",
        "2a3967",
        "8c4024",
        "",
        "f78b3c",
        "f69153",
        "a02e6a",
        "38606c",
        "ffcd53",
        "61969e",
        "00a2a5",
        "7a3e55",
        "95d1cf",
        "c8ad9c",
        "f7bc46",
        "32b5bd",
        "f06883",
        "eb524f",
        "f589c4",
        "70ccce",
        "9eb266",
        "f8be55",
        "ffcd53",
        "5f7bce",
        "e05a19",
        "e38238",
        "6c7297",
        "ffc408",
        "ced63f",
        "f39200",
        "9476b5",
        "b9171c",
        "ba6e34",
        "ef586a",
        "ff474d",
        "ced63f",
        "f39200"
    ]
}